..............................
..............................
....#########.................
....#########.................
....#......##.................
....#......##.................
....#......##.................
...........##.................
...........##.................
...........##.................
...........##.................
...........##.................
...........##.................
..............................
..............................
..............................
..............................
...........############.......
...........############.......
...........##.........#.......
...........##.........#.......
...........##.........#.......
...........##.................
...........##.................
...........##.................
..............................
..............................
..............................
..............................
..............................